1111111111111111111111111111111111
1E000000000000NC00000C000000000001
1N1001010010000N10100100N000010101
1010010010101010001001000000010101
1P0000000C00C00000000000000N0000C1
1111111111111111111111111111111111