111111111111
1C0ENC011111
101110011111
1P0000011111
111111111111