11111111111
1C0P00C0111
100E01100E1
11111111111