11111111111
100P00000E1
11111111111