11111111111111111111111111111111111111111
1P000000000000000000000000000000000000001
1ECCCCCCCCCCCCCCCCCCCCCCCCCCCCCCCCCCCCCC1
11111111111111111111111111111111111111111