1111111111111111111111111111111111111111111111111111
10000000C0000000000000000000000000000000000000000001
1011111111111111111111111111111111111111111111111001
1010000000000000000000000000000000000000000000000001
1010000000000000P00000000000000000000000000000000011
1010000000000000000000000000000000000000000000000001
1010000000000000000000000000000000000000000000000001
1010000000000000000000000000000000000000000000000001
1011111111111111111111111111111111111111111111111001
1010000000000000000000000000000000000000000000000001
1010000000000000000000000000000000000000000000000001
1010000000000000000000000000000000000000000000000001
1010000000000000000000000000000000000000000000000001
1011111111111111111111111111111111111111111111111001
1010000000000000000000000000000000000000000000000001
1010000000000000000000000000000000000000000000000001
1010000000000000000000000000000000000000000000000001
1010000000000000000000000000000000000000000000000001
1011111111111111111111111111111111111111111111111001
1E00000000000000000000000000000000000000000000000001
1111111111111111111111111111111111111111111111111111