11111111111
1C0P00000E1
11111111111